20 20
724 860
50 50 50 50 50 50 50 50 50 50 50 50 50 50 50 50 50 50 50 50
50 50 50 50 50 50 50 17 15 15 15 15 15 15 15 15 16 50 50 50
50 50 50 50 50 50 50 17 18 18 18 18 18 18 18 18 16 50 50 50
50 50 50 50 50 50 50 17 2 2 2 2 2 2 2 2 16 50 50 50
50 50 17 15 15 15 15 15 2 2 2 2 2 2 2 2 16 50 50 50
50 50 17 18 18 18 18 18 2 2 2 2 2 2 2 2 16 50 50 50
50 50 17 2 2 2 2 2 2 2 2 2 2 2 2 2 16 50 50 50
50 50 17 2 2 2 2 2 2 2 2 2 2 2 2 2 16 50 50 50
50 50 17 2 2 2 2 2 2 2 2 2 2 2 2 2 16 50 50 50
50 50 17 2 2 2 2 2 2 2 2 2 2 2 2 11 50 50 50 50
50 50 17 2 2 2 2 2 2 2 2 2 2 2 2 16 50 50 50 50
50 50 17 2 2 2 2 2 2 2 2 2 2 2 2 16 50 50 50 50
50 50 50 10 10 10 10 10 12 2 2 2 2 2 2 16 50 50 50 50
50 50 50 50 50 50 50 50 17 2 2 2 2 2 2 16 50 50 50 50
50 50 50 50 50 50 50 50 50 10 12 2 2 11 10 50 50 50 50 50
50 50 50 50 50 50 50 50 50 50 50 50 50 50 50 50 50 50 50 50
50 50 50 50 50 50 50 50 50 50 50 50 50 50 50 50 50 50 50 50
50 50 50 50 50 50 50 50 50 50 50 50 50 50 50 50 50 50 50 50
50 50 50 50 50 50 50 50 50 50 50 50 50 50 50 50 50 50 50 50
50 50 50 50 50 50 50 50 50 50 50 50 50 50 50 50 50 50 50 50