20 20
317 470
50 50 50 50 50 50 50 50 50 50 50 50 50 50 50 50 50 50 50 50
50 50 50 50 50 50 50 50 50 50 50 50 50 50 50 50 50 50 50 50
50 17 15 15 15 15 15 16 50 50 50 50 50 50 50 50 50 50 50 50
50 17 18 18 18 18 18 16 50 50 50 50 50 50 50 50 50 50 50 50
50 17 2 2 2 2 2 16 50 50 50 50 50 50 50 50 50 50 50 50
50 17 2 2 2 2 2 16 50 50 50 50 50 50 50 50 50 50 50 50
50 17 2 2 2 2 2 16 50 50 50 50 50 50 50 50 50 50 50 50
50 17 2 2 2 2 2 16 50 50 50 50 50 50 50 50 50 50 50 50
50 50 10 10 10 2 10 50 50 50 50 50 50 50 50 50 50 50 50 50
50 50 50 50 50 50 50 50 50 50 50 50 50 50 50 50 50 50 50 50
50 50 50 50 50 50 50 50 50 50 50 50 50 50 50 50 50 50 50 50
50 50 50 50 50 50 50 50 50 50 50 50 50 50 50 50 50 50 50 50
50 50 50 50 50 50 50 50 50 50 50 50 50 50 50 50 50 50 50 50
50 50 50 50 50 50 50 50 50 50 50 50 50 50 50 50 50 50 50 50
50 50 50 50 50 50 50 50 50 50 50 50 50 50 50 50 50 50 50 50
50 50 50 50 50 50 50 50 50 50 50 50 50 50 50 50 50 50 50 50
50 50 50 50 50 50 50 50 50 50 50 50 50 50 50 50 50 50 50 50
50 50 50 50 50 50 50 50 50 50 50 50 50 50 50 50 50 50 50 50
50 50 50 50 50 50 50 50 50 50 50 50 50 50 50 50 50 50 50 50
50 50 50 50 50 50 50 50 50 50 50 50 50 50 50 50 50 50 50 50