40 40
300 300
80 80 80 80 80 80 80 80 80 80 80 80 80 80 80 80 80 80 80 80 80 80 80 80 80 80 80 80 80 80 80 80 80 80 80 80 80 80 80 80
80 80 80 80 80 80 80 80 80 80 80 80 80 80 80 80 80 80 80 81 81 80 80 80 80 80 80 80 80 81 81 80 80 80 81 81 80 80 80 80
80 80 81 81 81 81 81 81 81 81 81 80 80 80 80 80 80 80 81 81 81 81 80 80 80 80 80 81 81 81 81 81 81 81 81 81 80 80 80 80
80 81 81 81 81 81 81 81 81 81 81 80 80 80 80 80 80 80 81 81 82 81 81 82 80 80 81 81 81 82 82 81 81 81 82 81 81 80 80 80
80 81 81 82 82 82 82 82 82 81 81 80 80 80 80 80 80 80 81 81 82 82 81 81 81 81 81 82 82 82 82 82 82 82 82 81 81 80 80 80
80 81 81 81 82 82 82 82 82 81 81 80 80 80 80 80 80 80 81 81 82 82 82 81 81 81 82 82 82 82 82 82 82 82 82 82 81 81 80 80
80 80 81 81 82 82 82 82 82 81 81 80 80 80 80 80 80 80 81 81 82 82 82 82 82 82 82 82 82 82 82 82 82 82 82 82 81 81 80 80
80 80 81 81 82 82 82 82 82 81 81 81 81 81 81 81 80 80 80 81 81 82 82 82 82 82 82 82 82 82 82 82 82 82 82 82 81 81 80 80
80 80 81 81 82 82 82 82 82 81 81 80 80 80 80 81 80 80 80 80 81 81 82 82 82 82 82 82 82 82 82 82 82 82 82 82 82 81 81 80
80 80 81 81 82 82 82 82 82 81 81 80 80 80 80 81 81 81 81 81 81 81 81 82 82 82 82 82 82 81 81 81 81 81 81 81 81 81 81 80
80 80 81 81 82 82 82 82 82 81 81 80 80 80 80 80 80 80 80 80 81 81 82 82 82 82 82 81 81 81 81 81 81 81 81 81 81 81 80 80
80 81 81 81 82 82 82 82 82 81 81 80 80 80 80 80 80 80 80 80 81 81 82 82 82 82 81 81 81 80 80 80 81 81 80 80 80 80 80 80
80 81 81 82 82 82 82 82 82 81 81 81 81 80 80 80 80 81 81 81 81 82 82 82 81 81 81 80 80 80 80 80 81 81 80 80 80 80 80 80
80 81 81 81 81 82 82 82 82 81 81 81 81 80 80 80 80 81 81 81 82 82 82 81 81 81 80 80 80 80 80 80 81 81 80 80 80 80 80 80
80 81 81 81 81 82 82 82 82 82 82 81 81 80 80 80 80 81 81 82 81 81 81 81 80 80 80 80 80 80 80 80 81 81 80 80 80 80 80 80
80 80 80 81 81 81 81 81 81 81 81 81 81 80 80 80 80 80 81 81 81 81 81 80 80 80 80 80 80 80 80 80 81 81 80 80 80 80 80 80
80 80 80 81 81 81 82 81 81 81 81 81 81 80 80 80 80 80 80 81 80 80 80 80 80 80 80 80 80 80 80 80 81 81 80 80 80 80 80 80
80 80 80 80 80 81 82 81 80 80 80 80 80 80 80 80 80 80 80 81 80 80 80 80 80 80 80 80 80 80 80 80 81 81 80 80 80 80 80 80
80 80 80 80 80 81 82 81 80 80 80 80 80 80 80 80 80 80 80 81 80 80 80 80 80 80 80 80 80 80 80 80 81 81 80 80 80 80 80 80
80 80 80 80 80 81 82 81 80 80 80 80 80 80 80 80 80 80 80 81 80 80 80 80 80 80 80 80 80 80 80 80 81 81 80 80 80 80 80 80
80 80 80 80 80 81 82 81 80 80 80 80 80 80 80 80 80 80 80 81 80 80 80 80 80 80 80 80 80 80 80 80 81 81 80 80 80 80 80 80
80 80 80 80 80 81 82 81 80 80 80 80 80 80 80 80 80 80 80 81 80 80 80 80 80 80 80 80 80 80 80 80 81 81 80 80 80 80 80 80
80 80 80 80 80 81 82 81 80 80 80 80 80 80 80 80 80 80 80 81 80 80 80 80 80 80 80 80 80 80 80 80 81 81 80 80 80 80 80 80
80 80 80 80 80 81 82 81 80 80 80 80 80 80 80 80 80 80 80 81 80 80 80 80 80 80 80 80 81 81 81 81 81 81 81 81 81 81 80 80
80 81 81 81 81 81 82 81 81 81 81 81 80 80 80 81 81 81 81 81 81 81 80 80 80 80 80 81 81 81 81 81 81 81 81 81 81 81 80 80
80 81 81 81 81 81 81 81 81 81 81 81 80 80 81 81 81 81 81 81 81 81 81 80 80 80 81 81 82 82 82 82 82 82 82 82 82 81 81 80
80 81 81 82 82 82 82 82 82 82 81 81 80 80 80 81 81 82 82 82 82 81 81 80 80 80 81 81 81 82 82 82 82 82 82 82 82 81 81 80
80 81 81 82 82 82 82 82 82 82 81 81 80 80 80 81 81 82 82 82 82 82 81 81 80 80 80 81 81 81 82 82 82 82 82 82 82 81 81 80
80 81 81 82 82 82 82 82 82 82 81 81 80 80 80 81 81 82 82 82 82 82 81 81 80 80 80 80 81 81 82 82 82 82 82 82 82 81 81 80
80 81 81 82 82 82 82 82 82 82 81 81 80 80 81 81 82 82 82 82 82 82 81 81 80 80 80 80 81 81 81 82 82 82 82 82 82 81 81 80
80 81 81 82 82 82 82 82 82 82 81 81 80 80 80 81 81 81 81 81 81 82 81 81 80 80 80 80 80 81 81 82 82 82 82 82 81 81 80 80
80 81 81 82 82 82 82 82 82 82 81 81 80 80 80 81 81 81 81 81 81 81 81 80 80 80 80 80 80 81 81 82 82 82 82 82 82 81 81 80
80 81 81 81 82 82 82 82 82 82 81 81 80 80 80 80 80 80 80 80 80 81 80 80 80 80 80 80 80 81 81 81 82 82 82 82 82 81 81 80
80 80 81 81 82 82 82 82 82 82 81 81 80 80 80 80 80 80 80 80 80 80 80 80 80 80 80 80 80 80 81 81 82 82 82 82 81 81 80 80
80 80 81 81 82 82 82 82 82 82 81 81 81 81 80 80 80 80 81 81 80 80 81 81 80 80 80 80 81 81 81 82 82 82 82 82 81 81 80 80
80 80 81 81 82 82 82 82 82 81 81 82 82 82 81 81 81 81 82 82 81 81 82 82 81 81 81 81 82 82 82 82 82 82 82 82 82 81 81 80
80 81 81 81 82 82 82 82 81 81 81 82 82 82 81 81 81 81 82 82 81 81 82 82 81 81 81 81 82 82 82 81 82 82 82 82 82 81 81 80
80 81 81 81 81 81 81 81 81 81 81 81 81 81 80 80 80 80 81 81 80 80 81 81 80 80 80 80 81 81 81 81 81 81 81 81 81 81 81 80
80 81 81 81 81 81 81 81 81 81 81 80 80 80 80 80 80 80 80 80 80 80 80 80 80 80 80 80 80 80 81 81 81 81 81 81 81 81 80 80
80 80 80 80 80 80 80 80 80 80 80 80 80 80 80 80 80 80 80 80 80 80 80 80 80 80 80 80 80 80 80 80 80 80 80 80 80 80 80 80

