40 40
300 300
20 20 20 20 20 20 20 20 20 20 20 20 20 20 20 20 20 20 20 20 20 20 20 20 20 20 20 20 20 20 20 20 20 20 20 20 20 20 20 20
20 20 20 20 20 20 20 20 20 20 20 20 20 20 20 20 20 20 20 20 20 20 20 20 20 20 20 20 20 20 20 20 20 20 20 20 20 20 20 20
20 20 19 19 19 19 19 19 19 20 20 20 20 20 20 20 19 19 19 19 19 19 19 19 19 19 19 19 19 19 19 19 19 19 20 20 20 20 20 20
20 20 19 19 19 19 19 19 19 20 20 20 20 20 19 19 19 19 19 19 19 19 19 19 19 19 19 19 19 19 19 19 19 19 19 20 19 19 20 20
20 20 19 19 19 19 19 19 19 20 20 20 20 19 19 19 19 19 19 19 19 19 19 19 19 19 19 19 19 19 19 19 19 19 19 19 19 19 20 20
20 20 19 19 19 19 19 19 19 20 20 20 19 19 19 19 19 19 19 19 19 19 19 19 19 19 19 19 19 19 19 19 19 19 19 19 19 19 20 20
20 20 19 19 19 19 19 19 19 20 20 19 19 19 19 19 19 19 19 19 19 19 19 19 19 19 19 19 19 19 19 19 19 19 19 19 19 19 20 20
20 20 19 19 19 19 19 19 19 20 19 19 19 19 19 19 19 19 19 19 19 19 19 19 19 19 19 19 19 19 19 19 19 19 19 19 19 20 20 20
20 20 19 19 19 19 19 19 19 19 19 19 19 19 19 19 19 19 19 19 19 19 19 19 19 19 19 19 19 19 19 19 19 19 19 19 20 20 20 20
20 20 19 19 19 19 19 19 19 19 19 19 19 19 19 19 19 19 19 19 19 19 19 19 19 19 19 19 19 19 19 19 19 19 19 20 20 20 20 20
20 20 19 19 19 19 20 20 20 20 20 20 19 19 20 20 20 20 20 20 20 20 20 20 20 20 20 20 20 20 20 20 19 19 20 20 20 20 20 20
20 20 19 19 19 19 20 20 20 20 20 20 19 19 20 20 20 20 20 20 20 20 20 20 20 20 20 20 20 20 20 20 19 19 20 20 20 20 20 20
20 20 19 19 19 19 20 20 20 20 20 20 19 19 20 20 20 20 20 20 20 20 20 20 20 20 20 20 20 20 20 20 19 19 20 20 20 20 20 20
20 20 19 19 19 19 20 20 20 20 20 20 19 19 20 20 20 20 20 20 20 20 20 20 20 20 20 20 20 20 20 20 19 19 20 20 20 20 20 20
20 20 19 19 19 19 20 20 20 20 20 20 19 19 19 19 19 19 19 19 19 19 19 19 19 19 19 19 19 19 19 19 19 19 19 19 20 20 20 20
20 20 19 19 19 19 19 19 19 19 19 19 19 19 19 19 19 19 19 19 19 19 19 19 19 19 19 19 19 19 19 19 19 19 19 19 20 20 20 20
20 20 19 19 19 19 19 19 19 19 19 19 19 19 20 20 20 20 20 20 20 19 19 19 19 19 19 19 19 19 19 19 19 19 19 19 20 20 20 20
20 20 20 19 19 19 20 20 20 20 20 19 19 19 20 20 20 20 20 20 20 19 19 19 19 19 19 19 19 19 19 19 19 19 19 19 20 20 20 20
20 20 20 19 19 19 20 20 20 20 20 19 19 19 20 20 20 20 20 20 20 19 19 19 20 20 20 19 19 19 20 20 20 19 19 19 20 20 20 20
20 20 20 19 19 19 20 20 20 20 20 20 20 20 20 20 20 20 20 20 20 19 19 19 20 20 20 19 19 19 20 20 20 19 19 19 20 20 20 20
20 20 20 19 19 19 20 20 20 20 20 20 20 20 20 20 20 20 20 20 20 19 19 19 20 20 19 19 19 19 19 20 20 19 19 19 20 20 20 20
20 20 20 19 19 19 20 20 20 20 20 20 20 20 20 20 20 20 20 20 20 19 19 19 20 19 19 19 19 19 19 19 20 19 19 19 20 20 20 20
20 20 20 19 19 19 20 20 20 20 20 20 20 20 20 20 20 20 20 20 20 19 19 19 19 19 19 19 19 19 19 19 19 19 19 19 20 20 20 20
20 20 20 19 19 19 20 20 20 20 20 20 20 20 20 20 20 20 20 20 20 19 19 19 19 19 19 19 19 19 19 19 19 19 19 19 20 20 20 20
20 20 20 19 19 19 20 20 20 20 20 20 20 20 20 20 20 20 20 20 20 19 19 19 20 19 19 19 19 19 19 19 20 19 19 19 20 20 20 20
20 20 20 19 19 19 20 20 20 20 20 20 20 20 20 20 20 20 20 20 20 19 19 19 20 20 19 19 19 19 19 20 20 19 19 19 20 20 20 20
20 20 20 19 19 19 20 20 20 20 20 20 20 20 20 20 20 20 20 20 20 19 19 19 20 20 20 19 19 19 20 20 20 19 19 19 19 20 20 20
20 20 20 19 19 19 20 20 20 20 20 20 20 20 20 20 20 20 20 20 20 19 19 19 20 20 20 19 19 19 20 20 20 19 19 19 19 20 20 20
19 19 19 19 19 19 19 19 19 19 19 19 20 20 20 20 20 20 20 20 20 19 19 19 19 19 19 19 19 19 19 19 19 19 19 19 19 20 20 20
19 19 19 19 19 19 19 19 19 19 19 19 20 20 20 20 20 20 20 20 20 19 19 19 19 19 19 19 19 19 19 19 19 19 19 19 19 20 20 20
21 19 19 19 19 19 19 19 19 19 19 19 20 20 20 20 20 20 20 20 20 19 19 19 19 20 20 20 20 20 20 20 19 19 19 19 19 20 20 20
22 21 19 19 19 19 19 19 19 19 19 19 20 20 20 20 20 20 20 20 20 19 19 19 19 19 20 20 20 20 20 19 19 19 19 19 19 20 20 20
22 22 21 19 19 19 19 19 19 19 19 19 19 20 20 20 20 20 20 20 20 19 19 19 19 19 20 20 20 20 19 19 19 19 19 19 19 20 20 20
22 22 22 21 19 19 19 19 19 19 19 19 19 19 19 19 19 19 19 19 19 19 19 19 19 19 20 20 20 19 19 19 19 19 19 19 19 20 20 20
22 22 22 22 21 19 19 19 19 19 19 19 19 19 19 19 19 19 19 19 19 19 19 19 19 19 19 20 19 19 19 19 19 19 19 19 19 20 20 20
22 22 22 22 22 21 19 19 19 19 19 19 19 19 19 19 19 19 19 19 19 19 19 19 19 19 19 19 19 19 19 19 19 19 19 19 19 20 20 20
22 22 22 22 22 22 21 19 19 19 19 19 19 20 20 20 20 20 20 20 20 20 19 19 19 19 19 19 19 19 19 19 19 19 19 19 19 20 20 20
22 22 22 22 22 22 22 21 19 19 19 19 20 20 20 20 20 20 20 20 20 20 20 20 20 20 20 20 20 20 20 20 20 20 20 20 20 20 20 20
22 22 22 22 22 22 22 22 21 19 19 19 20 20 20 20 20 20 20 20 20 20 20 20 20 20 20 20 20 20 20 20 20 20 20 20 20 20 20 20
22 22 22 22 22 22 22 22 22 21 19 19 20 20 20 20 20 20 20 20 20 20 20 20 20 20 20 20 20 20 20 20 20 20 20 20 20 20 20 20