40 40
300 300
50 50 50 50 50 50 50 50 50 50 50 50 50 50 50 50 50 50 50 50 50 50 50 50 50 50 50 50 50 50 50 50 50 50 50 50 50 50 50 50 
50 50 50 50 50 50 50 50 50 50 50 50 50 50 50 50 50 52 52 52 52 52 52 52 52 52 52 52 52 52 52 52 52 52 52 50 50 50 50 50 
50 50 50 50 52 52 52 52 52 50 50 50 50 50 50 50 54 51 51 51 51 51 51 51 51 51 51 51 51 51 51 51 51 51 51 55 50 50 50 50 
50 50 50 54 51 51 51 51 51 55 50 50 50 50 50 50 54 51 51 51 51 51 51 51 51 51 51 51 51 51 51 51 51 51 51 55 50 50 50 50                                                          
50 50 50 54 51 51 51 51 51 55 50 50 50 50 50 50 50 60 51 51 51 51 51 51 51 51 51 51 51 51 51 51 51 51 51 55 50 50 50 50                                                          
50 50 50 54 51 51 51 51 51 55 50 50 50 50 50 50 50 50 60 51 51 51 51 51 51 51 51 51 51 51 51 51 51 51 51 55 50 50 50 50                                                          
50 50 50 54 51 51 51 51 51 55 50 50 50 50 50 50 50 50 50 53 53 60 51 51 51 51 51 51 51 51 51 51 51 51 51 55 50 50 50 50                                                          
50 50 50 54 51 51 51 51 51 58 52 52 52 52 52 52 52 50 50 50 50 50 53 60 51 51 51 51 51 51 51 51 51 51 51 55 50 50 50 50                                          
50 50 50 54 51 51 51 51 51 51 51 51 51 51 51 51 51 55 50 50 50 50 50 50 53 60 51 51 51 51 51 51 51 51 51 55 50 50 50 50                                          
50 50 50 54 51 51 51 51 51 51 51 51 51 51 51 51 51 55 50 50 50 50 50 50 50 50 53 53 60 51 51 51 51 51 51 55 50 50 50 50                                          
50 50 50 54 51 51 51 51 51 51 51 51 51 51 51 51 51 55 50 50 50 50 50 50 50 50 50 50 50 60 51 51 51 51 51 55 50 50 50 50                                          
50 50 50 54 51 51 51 51 59 53 53 53 53 53 56 53 53 50 50 50 50 50 50 50 50 50 50 50 50 50 53 60 51 51 51 55 50 50 50 50                                          
50 50 50 50 53 53 53 53 50 50 50 50 50 50 56 50 50 50 50 50 50 50 50 50 50 50 50 50 50 50 50 50 53 56 53 50 50 50 50 50                                          
50 50 50 50 50 50 50 50 50 50 50 50 50 50 56 50 50 50 50 50 50 50 50 50 50 50 50 50 50 50 50 50 54 51 55 50 50 50 50 50                                          
50 50 50 50 50 50 50 50 52 52 52 52 52 52 56 52 52 52 52 52 52 52 52 52 52 52 52 52 50 50 50 50 54 51 55 50 50 50 50 50                     
50 50 50 50 50 50 50 54 51 51 51 51 51 51 51 51 51 51 51 51 51 51 51 51 51 51 51 51 55 50 50 50 54 51 55 50 50 50 50 50                     
50 50 50 50 50 50 50 54 51 51 51 51 51 51 51 51 51 51 51 51 51 51 51 51 51 51 51 51 55 52 52 52 57 51 55 50 50 50 50 50                     
50 50 50 50 50 50 50 54 51 51 51 51 51 51 51 51 51 51 51 51 51 51 51 51 51 51 51 51 61 51 51 51 51 51 55 50 50 50 50 50                     
50 50 50 50 50 50 50 54 51 51 51 51 51 51 51 51 51 51 51 51 51 51 51 51 51 51 51 51 55 53 53 53 60 51 55 50 50 50 50 50                     
50 50 50 50 50 50 50 54 51 51 51 51 51 51 51 51 51 51 51 51 51 51 51 51 51 51 51 51 55 50 50 50 54 51 55 50 50 50 50 50                     
50 50 50 50 50 50 50 54 51 51 51 51 59 53 53 53 53 53 53 53 53 53 53 53 53 53 53 53 50 50 50 50 54 51 55 50 50 50 50 50                    
50 50 50 50 50 50 50 54 51 51 51 51 55 50 50 50 50 50 50 50 50 50 50 50 50 50 50 50 50 50 50 50 54 51 55 50 50 50 50 50                                                      
50 50 50 50 50 50 50 54 51 51 51 51 55 50 50 52 52 52 52 52 52 52 52 52 52 52 52 52 52 50 52 52 52 56 52 52 52 50 50 50                                                      
50 50 52 52 52 52 52 57 51 51 51 51 55 50 54 51 51 51 51 51 51 51 51 70 68 69 51 51 51 61 51 51 51 51 51 51 51 55 50 50                                                      
50 54 51 51 51 51 51 51 51 51 51 51 55 50 54 51 51 51 51 51 51 51 51 70 68 69 51 51 55 50 53 53 53 53 53 60 51 55 50 50                                                      
50 54 51 51 51 51 51 51 51 51 51 51 55 50 54 62 62 62 62 62 62 56 62 62 62 62 62 62 55 50 50 50 50 50 50 54 51 55 50 50                                                      
50 54 51 51 51 51 51 51 51 51 51 51 55 50 54 63 63 63 63 68 63 56 63 63 63 63 63 63 55 50 50 50 50 50 50 54 51 55 50 50                                                      
50 54 51 51 51 51 51 51 51 51 51 51 55 50 54 51 51 51 51 51 51 51 51 70 68 69 51 51 55 50 52 52 52 50 50 54 51 55 50 50                                                      
50 50 53 56 53 53 53 60 51 51 51 51 55 50 54 51 51 51 64 65 51 51 51 70 68 69 51 51 55 54 51 51 51 55 50 54 51 55 50 50                                                      
50 50 54 51 55 50 50 54 51 51 51 51 55 50 54 51 51 64 68 68 65 51 51 70 68 69 51 51 55 54 51 51 51 55 50 54 51 55 50 50                                                      
50 50 54 51 55 50 50 54 51 51 51 51 55 50 54 51 51 66 68 68 68 65 51 61 61 61 51 51 55 54 51 51 51 55 50 54 51 55 50 50                                                      
50 50 54 51 55 50 50 54 51 51 51 51 55 50 54 51 51 51 66 63 63 67 51 70 68 69 51 51 55 54 51 51 51 55 50 54 51 55 50 50                                                      
50 50 54 51 55 50 50 54 51 51 51 51 55 50 54 51 51 51 51 51 51 51 51 70 68 69 51 51 55 54 51 51 51 58 52 57 51 55 50 50                                                      
50 50 54 51 55 50 50 50 53 53 53 53 50 50 50 53 53 53 53 53 56 53 53 53 53 53 53 53 50 54 51 51 51 51 51 51 51 55 50 50                                                      
50 50 54 51 55 50 50 50 50 50 50 50 50 50 50 50 50 50 50 50 56 50 50 50 50 50 50 50 50 50 60 51 59 53 53 60 51 55 50 50 
50 52 57 51 58 52 52 52 52 52 52 52 52 52 52 52 52 52 52 54 51 55 50 50 50 50 50 50 50 50 54 51 55 50 50 54 51 55 50 50                                                                                
54 51 51 51 51 51 51 51 51 51 51 51 51 51 51 51 51 51 51 61 51 58 52 52 52 52 52 52 52 52 57 51 58 52 52 57 51 55 50 50 
50 53 60 51 59 53 53 53 53 53 53 53 53 53 53 53 53 53 53 54 51 51 51 51 51 51 51 51 51 51 51 51 51 51 51 51 51 55 50 50 
50 50 54 51 55 50 50 50 50 50 50 50 50 50 50 50 50 50 50 50 53 53 53 53 53 53 53 53 53 53 53 53 53 53 53 53 53 50 50 50 
50 50 50 53 50 50 50 50 50 50 50 50 50 50 50 50 50 50 50 50 50 50 50 50 50 50 50 50 50 50 50 50 50 50 50 50 50 50 50 50 